1111111111111111111111111111111111111111
1111111111111111111111111111111111111111
1111111111111111111111111111111111111111
1222222222222222222222220000000000002221
1222222222222222222222220000000000002221
1222222222222222222222220000000000002221
1222222222222222222222220000000000002221
1222222222222222222222220000000000002221
1222222222222222222222220002220000002221
1222222222222222222200000002220000002221
1222000000000000000000000002220000002221
1222000000000000000000000002220000000000
1222220002200000000000000000000000000000
1222220002200000022222000000000000000000
1222220002200000022222000000000000000000
1222220002200000022222000000000000000000
1222220002200000022222000000000000000000
1222000000000000022222000000000000000001
1222000000000000000000000000000000000001
1000000000000000000000000000000000000001
1000000000000022222222200000000000002221
1000000000000022222222200000000000002221
10000P0002200022222222200000000000002221
1000000002200022222222200000000000002221
1000000002200022222222200000000000002221
1000000002200022222222222200000000002221
1000000002200022222222222222200000002221
1000000002200022222222222222200000002221
1000000002200022222222222200000000002221
1111111111111111111111111111111111111111