1111111111111111111111111111111111111111
1111111111111111111111111111111111111111
1111111111111111111111111111111111111111
122222222222222222222222............2221
122222222222222222222222............2221
122222222222222222222222............2221
122222222222222222222222............2221
122222222222222222222222............2221
122222222222222222222222...222......2221
12222222222222222222.......222......2221
1222.......................222......2221
1222.......................222..........
122222...22.............................
122222...22......22222..................
122222...22......22222..................
122222...22......22222..................
122222...22......22222..................
1222.............22222.................1
1222...................................1
1......................................1
1.............222222222.............2221
1.............222222222.............2221
1....P...22...222222222.............2221
1........22...222222222.............2221
1........22...222222222.............2221
1........22...222222222222..........2221
1........22...222222222222222.......2221
1........22...222222222222222.......2221
1........22...222222222222..........2221
1111111111111111111111111111111111111111
